###############
#.............#
#.............#
#.....####....#
#.....#.......#
#.....#.......#
#.....#.......#
#.....#.......#
###############